sobin		cn	ds	mat	
murali      cd	ai	fla	
jyothsna	dbms	coa ds
prakash     la	dm	ps
tapas		ai	ml	ds
shubam      cn	ds	mat	
jaya		cd	ai	fla	
priyanka	dbms	coa ds
sandeep     la	dm	ps
muzakkir	ai	ml	ds
satish      cn	ds	mat	
manjula     cn	ds	mat	
krishna     la	dm	ps
shuvendhu       cd	ai	fla	
anita       dbms	coa	ds
deepak      py	ds	mat	
sambit      cd	ai	fla	
niladri     dbms	coa ds
damodar     la	dm	ps
arnab       py	ai	fla	
ashu        ai	ml	ds
chinmaye	ai	ml	ds
sateesh     ac  ch  pr
pradyut     emb    jk  nko
sunitha     mpmc    jk  nko 
uday        aiml    ou  lkn
karthikeyan     aiml    ou  lkn
Gautam      miap    ch  pr
shubhankar      oop	ml	ds
vineesh	    eco 	py  	ds
Sushil      daa	ml	ds 
Vijay       dm	ml	ds 
Balaji      eco	ml	ds
sunil       de	ml	ai
Kavita      py	ml	ds
anabik	 oop    py  ds
dinesh	 daa    eco	ml	
ajay		 daa    py  daa 
sonali	 dm 	py  	ds
sanjay	daa 	py  ds 
anuj		de  	py  ds
manzoor	eco 	py  	daa  
pallab	dm  	py  	ds
abinash	oop 	py  ds
chinmaya	daa 	py  	ds
venkataramana	de  	py  	ds
monoj		de  	py	daa
ravikant	py 	ai 	ds
murtaja	eco 	py  	ds
ghanshyam	eco 	py  	ds
sangeeta	dm  	py  	ds
sudheer	oop 	py  ds
sibendhu	de  	py  	ds
swagata	de  	py	ds
rajiv		dm  	py  	ds
manikandan	daa 	py  ds
sudhakar	de  	py  	ds
manish	eco 	py  	ds
pallab	dm  	py  	ds
sonam		daa 	py  ds
stuti		eco  	py  	ds
rajkumar	dm  	py  	ds
manoj		oop 	py  ds
sowkuntla	py  	ai 	ds
inbarasan	de  	py  	ds
meenakshi	py 	bd  	ds
udayasankar	py  	eco	ds
banee		oop
satishtiwari	de  	py  	ds
sachin	dm  	py  	ds
ashok		eco 	py  ds
neeraj	    oop 	py  ds
krishnaprasad	py  	ai  	ds
sreenivasulu	de  	py  	ds
kamalsai	eco 	py  	ds
arghya	    py 	de 	dss
vijaykrishna	dm  	py  	ds
ramachandra	py 	cd 	ds
ranjana	    dm  	py  	ds
divya		de  	py  	ds
nitul		py  	py  	ds
satyaveer	de  	py  	ds
kannan	    dm  	py  	ds
